att vara -- to be;
att ha -- to have;
att kunna -- to be able to; to know;
--> continue databas from here
att unna, e.g. unna sig -- to grant, allow; 
att få -- to get, to receive; to be allowed to; to have to; to get; to manage; 
att bli -- to become;
att komma, e.g. komma fram/ihåg/in/ner/tillbaka/ut/överens -- to come; to arrive;
att vilja -- to want; to intend, to be going to; 
att göra, e.g. göra om/upp -- to do; to make; 
att finna -- to find, locate, discover; to have come to the conclusion/opinion that.
att ta (el. taga), e.g. ta av/bort/med/upp/ut -- to take, to bring, ...
att se, "e.g. se efter/upp/ut, se sig om" -- to see, to understand, form a mental picture of;
att gå, e.g. gå bort/fram/in/iväg/ner/omkring/runt/till/upp/ut/över -- go, walk, leave, start, (23 definitions ...)
att säga, e.g. säga upp sig -- to say, to tell;
att äga, e.g. äga rum -- to own; (egen)
att betyda -- to mean;
att ge (formellt giva), "e.g. ge upp/ut, ge sig, ge sig av" -- to give; to give up;
att skriva, e.g. skriva in/under/upp/ut -- to write; to type; to copy; to put letters and digits on a surface;
att te sig -- to appear;
att riva -- to tear, to rip; to grate; to scratch; to destruct (a building);
att börja -- to begin;
att tro -- to believe; to think;
att tycka, "e.g. tycka om, tycka synd om" -- to think of, have an opinion about;
att veta -- to know;
att försöka -- to attempt; to tryp;
att behöva -- to need; 
att känna, e.g. känna igen -- to feel; to remember; to know; 
att läsa, e.g. läsa igenom -- to read; 
att ro -- to row; 
att låta -- to make sound; to sound, to seem, to appear; to allow, to let;
att stå -- to stand; to be in an upright position; (of machinery) be at a standstill, not be running; (of events) be held, take place, happen; to be written down;
att visa, e.g. visa sig -- to show, to display; to prove; to point at;
att använda, "e.g. använda ngt, använda sig av" -- to use; 
att vända, e.g. vända sig -- to turn;
att hålla, e.g. hålla ut -- hold, grip; hold, cause to wait; hold, arrange a social event; keep; preserve; (reflexive) stay; to maintain, to keep from changing; to stop moving; to neither tear nor break; to remain in a functional condition;
att tänka, e.g. tänka igenom -- to think, to ponder; (på) keep in mind; intend, to plan on; (reflexive) to have on one's mind; (reflexive) consider as viable;
att söka -- to search (look throughout a place for something);
att ligga -- to lie; to be in a horizontal position; to lie, to be placed;
att lägga, "e.g. lägga fram/in/på/till/ut, lägga sig" -- lay, put, to place something down in a position of rest, in particular when it either lies flat or in an uncaring manner such as a heap; to put into a bag/pocket/box; (reflexive of snow) accumulate on the ground without melting; to go to bed; to play a card; to position oneself with respect to someone else who is moving in the same direction;
att anse -- to be of an opinion, feel, think, believe;
att öva -- to practice; to train to do something; to exercise;
att handla -- to shop, buy; to act, take action, do; to be about, deal with;
att öka -- to increase;
att skapa -- to create; to make; to manufacture, to put into existence, chiefly by a creative act;
att kapa -- to cut something in lengths; to hijack; to seize control over something;
att gälla -- to be valid; to be correct or proper;
att verka -- to work, to act; to seem as, appear, to have an appearance as of; 
att tala, e.g. tala om -- to speak, to utter words; to tell; to talk; to make a speech;
att bära -- to carry; to lift and transport anywhere; to wear, as clothing or jewelry;
att höra -- to hear; to perceive with the ear; to question; to interrogate; (often with `till`) to belong (to), to be a (necessary) part of;
att innebära -- to imply, to mean;
att välja -- to choose; to elect;
att förstå -- to understand;
att spela, e.g. spela in/upp -- to play, a game, a tune, a melody, an instrument or a role; to gamble; to wind (ropes and such);
att hitta, e.g. hitta på -- to find, to locate (an object); to stumble upon; to discover; to know one's way; to be able to locate places;
att dra, "e.g. dra av/in/ner/ut, dra nytta" -- to pull; to tell a short story or dirty joke; (slang) leave for some other place;
att leda -- to (gently) lead, to guide, to conduct; to be in the lead; to guide direct; to be in a position of leadership;
att lyckas -- succeed in; be successful in what one set out to do;
att lära -- to teach, to instruct; to learn, to study;
att sätta, e.g. sätta in/på -- (reflexive) to sit; to move oneself into a sitting position; to put or place; to make to stick or adhere to; to set; to put something (in particular, something immovable); to set or adjust; to choose a setting; to set; to assign work to; to prepare a text for printing; to plant certain plants, such as potatoes or onions;
att lämna, e.g. lämna in/tillbaka/över -- to leave; to not take away with oneself but leave as available for others; to deposit; to leave; to transfer responsibility to; to leave; to depart from;
att bygga -- to build; to construct;
att kalla -- to call, denote, refer to ; to give as a name; to call, request, beckon, summon;
att leva -- to live; to be alive;
att ställa, e.g. ställa in/upp/ut -- to set; to put something down in an upright position; to set; adjust (a setting, or a clock); to make someone speechless with confusion;
att följa -- to follow; to go after; follow; to be the next in a sequence; live ones life according to (religion, teachings, et cetera); to be a logical consequence of;
att ske -- to happen; in particular what happens during some extended period of time;
att kräva -- to demand; to forcefully request;
att ena -- to unite, to agree;
att svara -- to answer, to reply, to respond;
att fortsätta -- to continue, to proceed;
att bruka -- be used to; be in the habit of; to cultivate, till farm; (dated) to make use of;
att mena -- to mean, to convey, or to want to convey;
att slå, e.g. slå ihop/in/ner/upp -- hit, punch, beat, to give a blow; strike, to hit, especially with a tool; (of a clock) strike; defeat; win against; to beat; to break a record; throw a die, to take one of the opponents pieces out of play (in a board game); to cut or mow with a scythe;
att hända -- to happen; chiefly what happens quickly or for a short time;
att arbeta -- to work; to be employed to do; to do a specific task;
att fungera (vardagl. funka) -- to function; to be in action; work; to function correctly; work out, to succeed;
att beta -- to graze; to eat grass; to feed on growing herbage; to test software prior to release;
att köpa --  to buy
att sitta -- to sit;
att åta sig -- (reflexive) to take upon (oneself to do something)
att berätta -- to tell; to narrate;
att rätta -- to rectify, to correct; to direct, to align; to mark, to grade;
att sluta -- to stop, to quit, to cease doing something, to finish;
att åka  -- to go (by use of something other than the natural transporting functions of the human or animal body);
att betala -- to pay; (reflexive) to pay, to be profitable;
att utveckla -- to develop
att föra -- to lead in a partner dance; steer; to guide the course of; to bring from one point to another; to lead, to direct, to steer;
att hjälpa -- to help
att vinna -- to win, to defeat, to beat; to gain, to make a net profit;
att vänta -- to wait; to wait for, to expect;
att jobba -- to work (to do a specific task); to work;
att klara, "e.g. klara av, klara sig" -- to manage, to succeed in doing; (reflexive) to avoid being injured in an accident; (reflexive) make do, get by;
att prata -- to talk, to speak (informally)
att fråga -- to ask a question; to enquire;
att anmäla, e.g. anmäla sig -- report, notify authorities about something; sign up (for an activity); to make known that one has arrived;
att nå -- to reach, attain
att bo -- to live; dwell; to have permanent residence;
att stämma -- to agree, to correspond, to tally; to tune (an instrument); to arrange (a meeting); to summon, to sue;
att dela, e.g. dela ut -- to deal, share, divide something between recipients; to share; to have in common; to split; divide something in different parts;